####################
#                  #
# P                #
#                  #
#                  #
#                  #
#                  #
#                  #
#        M         #
#                  #
#                  #
#                  #
#    M             #
#                  #
#                  #
#                  #
#                  #
#           M      #
#                  #
#                  #
####################